NO	./textures/N.png
SO	./textures/S.png
EA	./textures/E.png
WE	./textures/W.png

F	0,255,255
C	250,255,0

111111111
111000111
110000001
100000001
100E00011
100000011
100000001
100000001
11111111