NO	./textures/N.png
SO	./textures/S.png
EA	./textures/E.png
WE	./textures/W.png

F	0,255,255
C	250,255,0

        111111111111111111111111
        1000000000110000000000001
        1001100000111000000000001
        1001000000000000000000001
111111111011000001110000000000001
100000000011000001110111111111111
11110111111111011100000010001
11110111111111011101010010001
11000000110101011100000010001
10000000000000001100000010001111111
100000000000000011010100000000000001
11000001110101011111000000N00000000111
11110111 1110101 100000000000000000101
11111111 1111111 11111111111111111111